1111111111111111111111111111111111
1E0000000000000C00000C000000000001
1010101110100010001110010101110001
1011101000100010001010010100010001
1011101000100010001010011100100001
1010101110111011101110000101110001
1P0000000C00C0000000000000000000C1
1111111111111111111111111111111111
